NO ./path_to_the_north_texture
SO ./path_to_the_south_texture
WE ./path_to_the_west_texture
EA ./path_to_the_east_texture

F 220,100,0
C 225,30,0

        1111111111111111111111111
        1000000000110000000000001
        1011000021110000000000001
        10010E0003000000000000001
111111111011000021110000000000001
100000000011000001110111111111111
11111111111111111111111111111
11111111111111111111111111111
1111111111111111111111111111    
11110111111111011101010010001
11000000111   111100000010001111111111111111111
10000000001   1100000000000000000000000000001
10000000011111101101010010001111111111111111111
1100000111010101111101111000111            1  1
11110111 11101011101111010001111111111111111111
1111111111111111111111111111