NO assets/sprites/only_wall.xpm
SO assets/sprites/only_wall.xpm
WE assets/sprites/only_wall.xpm
EA assets/sprites/only_wall.xpm

F 64,109,78
C 212,224,224

11111111111
10000000001
10000000001
10010000001
10001000001
100000000N1
11111111111
